26
1
2 5 6 

2
1 3

3
2 8 4

4
3 9 10 
buraco
5
1 6 11
armadilha
6
1 5 12

7


8
3 14

9
4 12 15

10
4 9 16

11
5 12 17

12
6 11 13

13
12 14 19

14
8 13 20

15
9 21 16

16
10 15 22 
saida
17
11 18 23

18
17 19 23 
armadilha
19
13 18 20

20
14 19 25 
buraco
21
15 22 26

22
16 21 26

23
17 18 24

24
23 25

25
20 24 26 
monstro
26
21 22 25

"<html> <pre> 
┌─────────────────────┬──────────┬──────────┬─────────────────────┐<br>
│01                   │02        │03        │04                   │<br>
░                     ║          ║          ║                     │<br>
│                     │          │          │                     │<br>
├────══────┬────══────┼──────────┼────══────┼────══────┬────══────┤<br>
│05        │06        │07        │08        │09        │10        │<br>
│          ║          │          │          │          ║          │<br>
│          │          │          │          │          │          │<br>
├────══────┼────══────┼──────────┼────══────┼────══────┼────══────┤<br>
│11        │12        │13        │14        │15        │16        │<br>
│          ║          ║          ║          │          ║          ▓<br>
│          │          │          │          │          │          │<br>
├────══────┼──────────┼────══────┼────══────┼────══────┼────══────┤<br>
│17        │18        │19        │20        │21        │22        │<br>
│          ║          ║          ║          │          ║          │<br>
│          │          │          │          │          │          │<br>
├────══────┴────══────┼──────────┼────══────┼────══────┴────══────┤<br>
│23                   │24        │25        │26                   │<br>
│                     ║          ║          ║                     │<br>
│                     │          │          │                     │<br>
└─────────────────────┴──────────┴──────────┴─────────────────────┘
</pre> </html>"